#, #, #, #, #, #, #, #, #, #, #, #, #, #, #, #, #, #, #, #, #, #, #, #, #, #, #, #, #, #, #, #,#
#, ., ., #, ., ., #, ., ., #, ., ., #, ., ., #, ., ., #, ., ., #, ., ., #, ., ., #, ., ., #, .,#
#, ., ., #, ., ., #, ., ., #, ., ., #, ., ., #, ., ., #, ., ., #, ., ., #, ., ., #, ., ., #, .,#
#, ., ., #, ., ., #, ., ., #, ., ., #, ., ., #, ., ., #, ., ., #, ., ., #, ., ., #, ., ., #, .,#
#, ., #, #, ., #, #, ., #, #, ., #, #, ., #, #, ., #, #, ., #, #, ., #, #, ., #, #, ., #, #, .,#
#, ., ., ., ., ., ., ., ., ., ., ., ., ., ., ., ., ., ., ., ., ., ., ., ., ., ., ., ., ., ., X,#
#, ., #, #, ., #, #, ., #, #, ., #, #, ., #, #, ., #, #, ., #, #, ., #, #, ., #, #, ., #, #, .,#
#, ., ., #, ., ., #, ., ., #, ., ., #, ., ., #, ., ., #, ., ., #, ., ., #, ., ., #, ., ., #, .,#
#, ., ., #, ., ., #, ., ., #, ., ., #, ., ., #, ., ., #, ., ., #, ., ., #, ., ., #, ., ., #, .,#
#, ., ., #, ., ., #, ., ., #, ., ., #, ., ., #, ., ., #, ., ., #, ., ., #, ., ., #, ., ., #, .,#
#, #, #, #, #, #, #, #, #, #, #, #, #, #, #, #, #, #, #, #, #, #, #, #, #, #, #, #, #, #, #, .,#
#, ., ., #, ., ., #, ., ., #, ., ., #, ., ., #, ., ., #, ., ., #, ., ., #, ., ., #, ., ., #, .,#
#, ., ., #, ., ., #, ., ., #, ., ., #, ., ., #, ., ., #, ., ., #, ., ., #, ., ., #, ., ., #, .,#
#, ., ., #, ., ., #, ., ., #, ., ., #, ., ., #, ., ., #, ., ., #, ., ., #, ., ., #, ., ., #, .,#
#, ., #, #, ., #, #, ., #, #, ., #, #, ., #, #, ., #, #, ., #, #, ., #, #, ., #, #, ., #, #, .,#
#, ., ., ., ., ., ., ., ., ., ., ., ., ., ., ., ., ., ., ., ., ., ., ., ., ., ., ., ., ., ., .,#
#, ., #, #, ., #, #, ., #, #, ., #, #, ., #, #, ., #, #, ., #, #, ., #, #, ., #, #, ., #, #, .,#
#, ., ., #, ., ., #, ., ., #, ., ., #, ., ., #, ., ., #, ., ., #, ., ., #, ., ., #, ., ., #, .,#
#, ., ., #, ., ., #, ., ., #, ., ., #, ., ., #, ., ., #, ., ., #, ., ., #, ., ., #, ., ., #, .,#
#, ., ., #, ., ., #, ., ., #, ., ., #, ., ., #, ., ., #, ., ., #, ., ., #, ., ., #, ., ., #, .,#
#, #, #, #, #, #, #, #, #, #, #, #, #, #, #, #, #, #, #, #, #, #, #, #, #, #, #, #, #, #, #, #,#
